                       +-----+                            ##############                                     
                       |.....|                            #            ##############                        
                     +-+.....+-+                          #                         ##############           
                     |.........|                          #                                      #           
                   +-+.........+-+                        #                                      #           
                   |.............|                        #                                      #####       
                 +-+....+--+.....+-+                      #                                          #       
                 |......|  |.......|                      #                                          #       
               +-+....+-+  +-+.....+-+                    #                                          ###     
              |.......|      |.......|                    #                                            #     
            +-+.....+-+      +-+.....+-+                  #                                            ##    
            |.......|          |.......|                  #                                             #    
          +-+.......+----------+.......+-+                #                                            ##    
          |..............................##################                                            #     
        +-+..............................+-+              #                                          ###     
        |...........+----------+...........|              #                                          #       
      +-+...........|          |...........+-+            #                                          #       
      |...........+-+          +-+...........|            #                                      #####       
    +-+...........|              |...........+-+          #                                      #           
    |...........+-+              +-+...........|          #                                      #           
  +-+...........|                  |...........+-+        #                         ##############           
  |...........+-+                  +-+...........|        #            ##############                        
  +-----------+                      +-----------+        ##############                                     